1111111111111
1001000000001
1000011111001
1PP011E00CC01
100011E00CC01
1111111111111