11111111111
10000C00001
1P0000000E1
11111111110